WorkerId,lastUpdate,payment,num_tasks_completed,amount_paid,last_payment_date,amount_to_pay
A15F2JTVAJXITI,1653578040098,24,8,12,2022-05-27T15:23:56Z,12
A15WCNO32MHBAF,1653339430964,9,3,6,2022-05-27T15:23:56Z,3
A17FGZ1I5P9RZA,1653685867921,102,34,51,2022-05-27T15:23:56Z,51
A17KN7NAP48L4B,1653082522111,24,8,18,2022-05-27T15:23:56Z,6
A18T7E73TNGOKP,1653686648489,60,20,15,2022-05-27T15:23:56Z,45
A19CB2C4GY4C60,1653181734859,3,1,3,2022-05-27T15:23:56Z,0
A1I72NHC21347A,1653668706917,138,46,129,2022-05-27T15:23:56Z,9
A1JCKAOZCEYUFT,1653687137219,9,3,0,NA,9
A1JED1RJM2C9MS,1653081346096,18,6,9,2022-05-27T15:23:56Z,9
A1NLP66FKHBS4V,1653685218605,30,10,18,2022-05-27T15:23:56Z,12
A1PZIN8H1VI6SY,1653308478734,9,3,9,2022-05-27T15:23:56Z,0
A1VRG5HKZC0H0C,1653579825511,93,31,84,2022-05-27T15:23:56Z,9
A1WPCMXFU9NH9G,1653588700505,9,3,3,2022-05-27T15:23:56Z,6
A1X9RXT7MI571,1653684977224,9,3,0,NA,9
A1YSYI926BBOHW,1653458042199,84,28,42,2022-05-27T15:23:56Z,42
A1ZE87WEYCA44A,1653580520026,60,20,60,2022-05-27T15:23:56Z,0
A2078XQX9ZSWBC,1653252540033,6,2,3,2022-05-27T15:23:56Z,3
A230VUDYOCRZ4N,1653184535428,3,1,3,2022-05-27T15:23:56Z,0
A23BWWRR7J5XLS,1653081791534,15,5,3,2022-05-27T15:23:56Z,12
A2531UD0IGT731,1653078136723,6,2,6,2022-05-27T15:23:56Z,0
A2615YW1YERQBO,1653685837689,18,6,9,2022-05-27T15:23:56Z,9
A26GDUUFGPAYUL,1653079250893,3,1,3,2022-05-27T15:23:56Z,0
A26UIS59SY4NM6,1653189401775,15,5,15,2022-05-27T15:23:56Z,0
A272X64FOZFYLB,1653685698552,69,23,36,2022-05-27T15:23:56Z,33
A27W025UEXS1G0,1653086721938,3,1,3,2022-05-27T15:23:56Z,0
A2AZYU1CT24O0K,1653669067905,33,11,24,2022-05-27T15:23:56Z,9
A2H5V1V8QIY8Y7,1653183500436,12,4,12,2022-05-27T15:23:56Z,0
A2IFHU3P1MF54K,1653078176367,6,2,3,2022-05-27T15:23:56Z,3
A2LSX4F8D3Z0OR,1653187799506,3,1,3,2022-05-27T15:23:56Z,0
A2N9Q1IHLP4LGI,1653267393604,3,1,3,2022-05-27T15:23:56Z,0
A2ONILC0LZKG6Y,1653684123891,9,3,6,2022-05-27T15:23:56Z,3
A2OVX9UW5WANQE,1653686303320,3,1,0,NA,3
A2QXNIG0GVVXLG,1653086225222,3,1,3,2022-05-27T15:23:56Z,0
A2S64AUN7JI7ZS,1653339485977,48,16,45,2022-05-27T15:23:56Z,3
A2TLN8489YGY81,1653084049970,48,16,24,2022-05-27T15:23:56Z,24
A2TVG2HLMKVMSL,1653519929212,9,3,9,2022-05-27T15:23:56Z,0
A2UKCO1M1MEMZW,1653669327718,6,2,3,2022-05-27T15:23:56Z,3
A2VRDE2FHCBMF8,1653686422617,78,26,15,2022-05-27T15:23:56Z,63
A2WDF40FA670T9,1653081654621,24,8,12,2022-05-27T15:23:56Z,12
A2WZTMXWD20NYE,1653685497801,81,27,75,2022-05-27T15:23:56Z,6
A2YW35WSBU88O0,1653189848592,6,2,6,2022-05-27T15:23:56Z,0
A31BA1WLSWUSY1,1653592585422,27,9,24,2022-05-27T15:23:56Z,3
A32YYM8WVR8B7S,1653687827202,3,1,0,NA,3
A33PHCBUOD4WKD,1653251577695,15,5,3,2022-05-27T15:23:56Z,12
A37EV8RZ82WT8E,1653683952425,3,1,0,NA,3
A38I0E8UK53ME5,1653592708884,57,19,57,2022-05-27T15:23:56Z,0
A3CGQOJC28OVGN,1653079938809,48,16,30,2022-05-27T15:23:56Z,18
A3EUGO4VR2N4G1,1653577141195,54,18,42,2022-05-27T15:23:56Z,12
A3HGZDLMCKGPSE,1653078182311,3,1,3,2022-05-27T15:23:56Z,0
A3HL2LL0LEPZT8,1653295879191,147,49,84,2022-05-27T15:23:56Z,63
A3I9XLIHPPWPN1,1653082343376,48,16,24,2022-05-27T15:23:56Z,24
A3JAM040VWXHDO,1653266459007,42,14,42,2022-05-27T15:23:56Z,0
A3NXT3OVGL7QNR,1653267250902,33,11,33,2022-05-27T15:23:56Z,0
A3S5ZB4D98JWT1,1653683356311,81,27,42,2022-05-27T15:23:56Z,39
A3T9WZOUQGE2UW,1653081879443,24,8,12,2022-05-27T15:23:56Z,12
A3UJSDFJ9LBQ6Z,1653083901721,3,1,3,2022-05-27T15:23:56Z,0
A3V3SQCM8QGYB7,1653687181442,45,15,15,2022-05-27T15:23:56Z,30
A5NE8TWS8ZV7B,1653079554089,81,27,36,2022-05-27T15:23:56Z,45
A6JKKANO7F4KD,1653684867219,24,8,3,2022-05-27T15:23:56Z,21
A76WEZ9QGREEM,1653251308799,9,3,9,2022-05-27T15:23:56Z,0
A8C3WNWRBWUXO,1653687694333,42,14,6,2022-05-27T15:23:56Z,36
AA5ZDXAA2DLY1,1653084176802,42,14,42,2022-05-27T15:23:56Z,0
AE1YA7Q3UKPRI,1653303647218,9,3,9,2022-05-27T15:23:56Z,0
AHUNR2YEZW58R,1653266135781,6,2,6,2022-05-27T15:23:56Z,0
AKQAI78JTXXC9,1653686473492,120,40,102,2022-05-27T15:23:56Z,18
AL51KTD0WITH9,1653297135670,24,8,24,2022-05-27T15:23:56Z,0
AONSG5WOC3OX0,1653686709740,9,3,3,2022-05-27T15:23:56Z,6
ARI1EMAHUA9PO,1653589187020,84,28,69,2022-05-27T15:23:56Z,15
ARYL3C6N9SVV1,1653087639107,33,11,30,2022-05-27T15:23:56Z,3
AURYD2FH3FUOQ,1653651186923,9,3,6,2022-05-27T15:23:56Z,3
AW5O1RK3W60FC,1653339074757,6,2,6,2022-05-27T15:23:56Z,0
AWAW665TQQP2F,1653270719309,33,11,33,2022-05-27T15:23:56Z,0
AXPZAP62ZYWP8,1653684104789,162,54,96,2022-05-27T15:23:56Z,66
AZKC2HLJOVL04,1653684242247,6,2,0,NA,6
